111111111111111111
1P0111000000000001
1C01000010000C0001
1C01001110C0000001
1C01000C10C0000001
1C01110C10C0000001
1C01C00C10C0000001
1C01C00C10C0000001
10C1C0111000000E01
10C0C00C1000C0C001
111111111111111111